
NO textures/N.xpm


SO textures/S.xpm


EA textures/E.xpm


WE textures/W.xpm

F 0,0,0


C 250,20,0

11111111111111111111111111111111111111111111111111111111111111111111111111111111
10000000000000000000100000000000000000000000000000W00000000000000000000000000001
10111111111111111110111111111011111111111111111111101111111011111111111111111101
10000000000000000000100000000000000000000001000000001000000000000000000000000001
10111111111111111110111111101111111111111011111111101111111111111111111111111101
10000000000000000000100000000000000000001000000000000000000000000000000000000001
10111111111111111111101111111111111111111011111101101111111111111111111111111001
10000000000000000000100000000000000000001000000000001000000000000000000000001001
11111111111111111110111111111111101111111111101111111111111111111111111111111001
10000000000000000000100000000000001000000000001000000000000000000000000000000001
10111111111111111111111111111111101111101111111111111111111111111111111111111101
10000000000000000000000000000000001000001000000000001000000000000000000000000001
11111111111111111111111111111111101111101111111111101111111111111111111111111101
10000000000000000000000000000000000000000000000000000000000000000000000000000001
10111111111111011111111111111111101111111111011111111111111111000111111111111101
10000000000000000000001000000000000000100000000001000000000000000000000000000001
11111111111111111111111111111111111111111111011111111111111111000111111111111101
10000000000000000000000000000000000000000000000000000000000000110000000000000001
10111111111111111111111111111111111111111111001111111111111111110111111111111101
10000000000000011111111110011111111100000000000000000000000000001000000000000001
11111111111111110011111111111111111111110011111111111111111111111100111111111101
10000000000000010000000111110000000100000000000000000000000000000000000000000001
101111111111111100000001   10000000100000000000000000000000000000000000000000001
10000000000000010000000111110000000100000000000000000000000000000000000000000001
10111111111111110000000111110000000111110111111101111101111111111111111111111101
10000000000000010000000000000000000100100010000000001000100000000000000000000001
10111111111111111111001111101111110111111111101111110111111101111111111111111101
10000000010111110000000000000000000000000000000000000000000000000000000000000001
10000000010000000000000000000000000000000000000000000000000000000000000000000001
11111111111111111111111111111111111111111111111111111111111111111111111111111111
