
NO textures/1.xpm


SO textures/2.xpm


EA textures/3.xpm


WE textures/4.xpm






F 220,100,0


C 225,30,0

1111111111111111111111111
1000000000110001000000001
10110000011100100N0001001
1001000000000000000000011
1111111111111111111111111
