
NO textures/1.xpm


SO textures/2.xpm


EA textures/3.xpm


WE textures/4.xpm






F 255,0,255


C 228,20,0

1111111111111111
1011000100001101
1010000010100111
1011000100001001
1011001100000001
1011001100000001
1011001101000001
1011001100000001
1000000000000011
1111111111111111
1111111111111111
1011000100001001
1101000001010001
1011000100001001
1011001100000001
1011001100000001
1011001101000001
1011001100000001
1S00000000000011
1111111111111111