
NO textures/1.xpm


SO textures/2.xpm


EA textures/3.xpm


WE textures/4.xpm






F 220,100,0


C 225,30,0

1111111111111111
1001000100001001
1001000001010001
1001000100001001
1011001100000001
1011001100000001
1011001101000001
1011001100000001
100000000N000011
1111111111111111
