
NO textures/N.xpm


SO textures/S.xpm


EA textures/E.xpm


WE textures/W.xpm






F 0,0,0


C 228,20,0

1111111111111111
1011000100001101
1010000010100111
1011000100001001
1011001100000001
10110011000000E1
1011001101000001
1011001100000001
1000000000000011
1111111111111111
