
NO textures/1.xpm


SO textures/2.xpm


EA textures/3.xpm


WE textures/4.xpm






F 220,100,0


C 225,30,0

1111111111111111111111111
1000000000110000000000001
1011000001110000000000001
1001000000N00000000000001
1111111111111111111111111